1,2,3,1,2,3,1,2,3,1,2,3,1,2,3,1,2,3,1,2,3,1,2,3,1,2,3,1,2,3,1,2
1,2,3,1,2,3,1,2,3,1,2,3,1,2,3,1,2,3,1,2,3,1,2,3,1,2,3,1,2,3,1,2
1,2,3,1,2,3,1,2,3,1,2,3,1,2,3,1,2,3,1,2,3,1,2,3,1,2,3,1,2,3,1,2
1,2,3,1,2,3,1,2,3,1,2,3,1,2,3,1,2,3,1,2,3,1,2,3,1,2,3,1,2,3,1,2
1,2,3,1,2,3,1,2,3,1,2,3,1,2,3,1,2,3,1,2,3,1,2,3,1,2,3,1,2,3,1,2
1,2,3,1,2,3,1,2,3,1,2,3,1,2,3,1,2,3,1,2,3,1,2,3,1,2,3,1,2,3,1,2
1,2,3,1,2,3,1,2,3,1,2,3,1,2,3,1,2,3,1,2,3,1,2,3,1,2,3,1,2,3,1,2
1,2,3,1,2,3,1,2,3,1,2,3,1,2,3,1,2,3,1,2,3,1,2,3,1,2,3,1,2,3,1,2
1,2,3,1,2,3,1,2,3,1,2,3,1,2,3,1,2,3,1,2,3,1,2,3,1,2,3,1,2,3,1,2
1,2,3,1,2,3,1,2,3,1,2,3,1,2,3,1,2,3,1,2,3,1,2,3,1,2,3,1,2,3,1,2
1,2,3,1,2,3,1,2,3,1,2,3,1,2,3,1,2,3,1,2,3,1,2,3,1,2,3,1,2,3,1,2
1,2,3,1,2,3,1,2,3,1,2,3,1,2,3,1,2,3,1,2,3,1,2,3,1,2,3,1,2,3,1,2
1,2,3,1,2,3,1,2,3,1,2,3,1,2,3,1,2,3,1,2,3,1,2,3,1,2,3,1,2,3,1,2
1,2,3,1,2,3,1,2,3,1,2,3,1,2,3,1,2,3,1,2,3,1,2,3,1,2,3,1,2,3,1,2
1,2,3,1,2,3,1,2,3,1,2,3,1,2,3,1,2,3,1,2,3,1,2,3,1,2,3,1,2,3,1,2
1,2,3,1,2,3,1,2,3,1,2,3,1,2,3,1,2,3,1,2,3,1,2,3,1,2,3,1,2,3,1,2
1,2,3,1,2,3,1,2,3,1,2,3,1,2,3,1,2,3,1,2,3,1,2,3,1,2,3,1,2,3,1,2
1,2,3,1,2,3,1,2,3,1,2,3,1,2,3,1,2,3,1,2,3,1,2,3,1,2,3,1,2,3,1,2
1,2,3,1,2,3,1,2,3,1,2,3,1,2,3,1,2,3,1,2,3,1,2,3,1,2,3,1,2,3,1,2
1,2,3,1,2,3,1,2,3,1,2,3,1,2,3,1,2,3,1,2,3,1,2,3,1,2,3,1,2,3,1,2
1,2,3,1,2,3,1,2,3,1,2,3,1,2,3,1,2,3,1,2,3,1,2,3,1,2,3,1,2,3,1,2
1,2,3,1,2,3,1,2,3,1,2,3,1,2,3,1,2,3,1,2,3,1,2,3,1,2,3,1,2,3,1,2
1,2,3,1,2,3,1,2,3,1,2,3,1,2,3,1,2,3,1,2,3,1,2,3,1,2,3,1,2,3,1,2
1,2,3,1,2,3,1,2,3,1,2,3,1,2,3,1,2,3,1,2,3,1,2,3,1,2,3,1,2,3,1,2

75,0,0,0,75,0,0,0,75,0,0,0,75,0,0,0,75,0,0,0,75,0,0,0,75,0,0,0,75,0,0,0
75,0,0,0,75,0,0,0,75,0,0,0,75,0,0,0,75,0,0,0,75,0,0,0,75,0,0,0,75,0,0,0
75,0,0,0,75,0,0,0,75,0,0,0,75,0,0,0,75,0,0,0,75,0,0,0,75,0,0,0,75,0,0,0
75,0,0,0,75,0,0,0,75,0,0,0,75,0,0,0,75,0,0,0,75,0,0,0,75,0,0,0,75,0,0,0
75,0,0,0,75,0,0,0,75,0,0,0,75,0,0,0,75,0,0,0,75,0,0,0,75,0,0,0,75,0,0,0
75,0,0,0,75,0,0,0,75,0,0,0,75,0,0,0,75,0,0,0,75,0,0,0,75,0,0,0,75,0,0,0
75,0,0,0,75,0,0,0,75,0,0,0,75,0,0,0,75,0,0,0,75,0,0,0,75,0,0,0,75,0,0,0
75,0,0,0,75,0,0,0,75,0,0,0,75,0,0,0,75,0,0,0,75,0,0,0,75,0,0,0,75,0,0,0
75,0,0,0,75,0,0,0,75,0,0,0,75,0,0,0,75,0,0,0,75,0,0,0,75,0,0,0,75,0,0,0
75,0,0,0,75,0,0,0,75,0,0,0,75,0,0,0,75,0,0,0,75,0,0,0,75,0,0,0,75,0,0,0
75,0,0,0,75,0,0,0,75,0,0,0,75,0,0,0,75,0,0,0,75,0,0,0,75,0,0,0,75,0,0,0
75,0,0,0,75,0,0,0,75,0,0,0,75,0,0,0,75,0,0,0,75,0,0,0,75,0,0,0,75,0,0,0
75,0,0,0,75,0,0,0,75,0,0,0,75,0,0,0,75,0,0,0,75,0,0,0,75,0,0,0,75,0,0,0
75,0,0,0,75,0,0,0,75,0,0,0,75,0,0,0,75,0,0,0,75,0,0,0,75,0,0,0,75,0,0,0
75,0,0,0,75,0,0,0,75,0,0,0,75,0,0,0,75,0,0,0,75,0,0,0,75,0,0,0,75,0,0,0
75,0,0,0,75,0,0,0,75,0,0,0,75,0,0,0,75,0,0,0,75,0,0,0,75,0,0,0,75,0,0,0
75,0,0,0,75,0,0,0,75,0,0,0,75,0,0,0,75,0,0,0,75,0,0,0,75,0,0,0,75,0,0,0
75,0,0,0,75,0,0,0,75,0,0,0,75,0,0,0,75,0,0,0,75,0,0,0,75,0,0,0,75,0,0,0
75,0,0,0,75,0,0,0,75,0,0,0,75,0,0,0,75,0,0,0,75,0,0,0,75,0,0,0,75,0,0,0
75,0,0,0,75,0,0,0,75,0,0,0,75,0,0,0,75,0,0,0,75,0,0,0,75,0,0,0,75,0,0,0
75,0,0,0,75,0,0,0,75,0,0,0,75,0,0,0,75,0,0,0,75,0,0,0,75,0,0,0,75,0,0,0
75,0,0,0,75,0,0,0,75,0,0,0,75,0,0,0,75,0,0,0,75,0,0,0,75,0,0,0,75,0,0,0
75,0,0,0,75,0,0,0,75,0,0,0,75,0,0,0,75,0,0,0,75,0,0,0,75,0,0,0,75,0,0,0
75,0,0,0,75,0,0,0,75,0,0,0,75,0,0,0,75,0,0,0,75,0,0,0,75,0,0,0,75,0,0,0

0,0,43,0,0,0,0,0,0,0,0,0,0,0,0,0,0,0,0,0,0,0,0,0,0,0,0,0,0,0,0,0
0,0,43,0,0,0,0,0,0,0,0,0,0,0,0,0,0,0,0,0,0,0,0,0,0,0,0,0,0,0,0,0
0,0,43,0,0,0,0,0,0,0,0,0,0,0,0,0,0,0,0,0,0,0,0,0,0,0,0,0,0,0,0,0
0,0,43,0,0,0,0,0,0,0,0,0,0,0,0,0,0,0,0,0,0,0,0,0,0,0,0,0,0,0,0,0
0,0,43,0,0,0,0,0,0,0,0,0,0,0,0,0,0,0,0,0,0,0,0,0,0,0,0,0,0,0,0,0
0,0,43,0,0,0,0,0,0,0,0,0,0,0,0,0,0,0,0,0,0,0,0,0,0,0,0,0,0,0,0,0
0,0,43,0,0,0,0,0,0,0,0,0,0,0,0,0,0,0,0,0,0,0,0,0,0,0,0,0,0,0,0,0
0,0,43,0,0,0,0,0,0,0,0,0,0,0,0,0,0,0,0,0,0,0,0,0,0,0,0,0,0,0,0,0
0,0,43,0,0,0,0,0,0,0,0,0,0,0,0,0,0,0,0,0,0,0,0,0,0,0,0,0,0,0,0,0
0,0,43,0,0,0,0,0,0,0,0,0,0,0,0,0,0,0,0,0,0,0,0,0,0,0,0,0,0,0,0,0
0,0,43,0,0,0,0,0,0,0,0,0,0,0,0,0,0,0,0,0,0,0,0,0,0,0,0,0,0,0,0,0
0,0,43,0,0,0,0,0,0,0,0,0,0,0,0,0,0,0,0,0,0,0,0,0,0,0,0,0,0,0,0,0
0,0,43,0,0,0,0,0,0,0,0,0,0,0,0,0,0,0,0,0,0,0,0,0,0,0,0,0,0,0,0,0
0,0,43,0,0,0,0,0,0,0,0,0,0,0,0,0,0,0,0,0,0,0,0,0,0,0,0,0,0,0,0,0
0,0,43,0,0,0,0,0,0,0,0,0,0,0,0,0,0,0,0,0,0,0,0,0,0,0,0,0,0,0,0,0
0,0,43,0,0,0,0,0,0,0,0,0,0,0,0,0,0,0,0,0,0,0,0,0,0,0,0,0,0,0,0,0
0,0,43,0,0,0,0,0,0,0,0,0,0,0,0,0,0,0,0,0,0,0,0,0,0,0,0,0,0,0,0,0
0,0,43,0,0,0,0,0,0,0,0,0,0,0,0,0,0,0,0,0,0,0,0,0,0,0,0,0,0,0,0,0
0,0,43,0,0,0,0,0,0,0,0,0,0,0,0,0,0,0,0,0,0,0,0,0,0,0,0,0,0,0,0,0
0,0,43,0,0,0,0,0,0,0,0,0,0,0,0,0,0,0,0,0,0,0,0,0,0,0,0,0,0,0,0,0
0,0,43,0,0,0,0,0,0,0,0,0,0,0,0,0,0,0,0,0,0,0,0,0,0,0,0,0,0,0,0,0
0,0,43,0,0,0,0,0,0,0,0,0,0,0,0,0,0,0,0,0,0,0,0,0,0,0,0,0,0,0,0,0
0,0,43,0,0,0,0,0,0,0,0,0,0,0,0,0,0,0,0,0,0,0,0,0,0,0,0,0,0,0,0,0
0,0,43,0,0,0,0,0,0,0,0,0,0,0,0,0,0,0,0,0,0,0,0,0,0,0,0,0,0,0,0,0
